11111111111
10000000001
10000001001
1P000011101
10000000001
11111111111