111111111111111
100100000000001
100100010000001
1P0000111000001
100111000000001
100000000000001
100000000000001
100000000000001
100000000000001
111111111111111