11111111111
10010000001
10010001001
1P000011101
10010000001
11111111111